NO     /Users/lmuzio/Downloads/aaa.png


SO ./assets/wallreal2.png

WE ./assets/wallreal3.png
	EA	 ./assets/wallreal5.png
C                     1,             43         ,2
     F 			0,0,0,
     F 			0,0,0
     F 			0,0,0
C                     1,             43         ,2

WE ./assets/wallreal3.png

        1111111111111111111111111
        1000000000110000000000001
        1011000001110000000000001
        1001000000000000000000001
111111111011000001110000000000001
100000000011000001110111111111111
11110111111111011100000010001
11110111111111011101010010001
11000000110101011100000010001
10001000000000001100000000001
10000000000000001100000000001
10000000000000001100000000001
10000000000000001100000000001
10000000000000001100000000001
10000000000000001100000000001
10000000000000001100000000001
10000000000000001100000000001
10000000000000001100000000001
10000000000000001100001000001
10000000000000001100000000001
10000000000000001100000000001
10000000000000001100000000001
10000000000000001100000000001
10000000000000001100000000001
10000000000000001100000000001
10000000000000001100000000001
10000000000000001100000000001
10000000000000001100000000001
1000000000000000110101001000111111
11000001110101011111011110W0000001
11110111 1110101 10111101000111111
11111111 1111111 11111111111


        1111111111111111111111111
        1000000000110000000000001
        1011000001110000000000001
        1001000000000000000000001
111111111011000001110000000000001
100000000011000001110111111111111
11110111111111011100000010001
11110111111111011101010010001
11000000110101011100000010001
10000000000000001100000000001
10000000000000001101010010001
11000001110101011111011110N0111
11110111 1110101 101111010001
11111111 1111111 111111111111


111111111111
100000000001
100000000001
1000000N0001
100000000001
111111111111






111111111111
1000000E0001
100000000001
111111111111
