NO ./assets/wallreal1.png


SO ./assets/wallreal2.png

WE ./assets/wallreal3.png
	EA	 ./assets/wallreal5.png
C                     1,43,2
     F 			4,20,8

11111111111111
10000000000001
10011000010001
10011000011001
10000000000001
10011111111001
1S000000000001
11111111111111
