NO ./assets/wallreal1.png


SO ./assets/wallreal2.png

WE ./assets/wallreal3.png
	EA	 ./assets/wallreal5.png
C                     1,43,2
     F 			4,20,8

111
1S1
111

111111111111
100000000001
100000S00001
111111111111
